# 默认资源
alreadyConnected=节点已经连接
cancel=取消
close=关闭
collapse-expand=收缩/关闭
containsValidationErrors=包含验证错误
done=完成
doubleClickOrientation=双击改变方向
error=错误
ok=成功
updatingDocument=正在更新Document，请稍候...
updatingSelection=正在更新Selection，请稍候...

# 自定义资源
about=关于
actualSize=实际大小
addToExistingDrawing=添加到现有的图纸
align=对齐
alignment=对齐
allChangesLost=所有更改都将丢失!
apply=应用
arrange=排列
arrow=箭头
arrows=箭头
autosize=自动大小
backgroundColor=背景颜色
basic=基本
block=方形
bold=加粗
borderWidth=边框宽度
borderColor=边框颜色
bottom=按钮
bottomAlign=按钮对齐
center=居中
changeOrientation=改变方向
circle=圆开
classic=经典
clipart=剪纸
collapse=收缩
connect=连接
connection=连接
copy=复制
copyConnect=在连接上复制
curved=弯曲
custom=自定义
cut=剪切
dashed=虚线
delete=删除
diamond=菱形
diamondThin=菱形 (小)
direction=方向
drawing=绘制{1}
drawingEmpty=绘制的内容为空
drawingTooLarge=绘画的内容太大
duplicate=副本
east=东
edit=编辑
editLink=编辑链接
enterGroup=组名
enterValue=输入值
entityRelation=实体关系
exitGroup=退出组
expand=展开
export=导出
file=文件
fileNotFound=文件没有找到
filename=文件名
fillColor=填充
fitPage=第 1 页
fitPageWidth=页宽度
fitWindow=适应窗口大小
flipH=适应水平大小
flipV=适应垂直大小
fontFamily=字体
fontColor=字体颜色
fontSize=字体大小
format=格式
general=常规
global=全局
gradient=渐变
gradientColor=颜色
grid=表格
group=组合
guides=指南
height=高度
help=帮助
hide=隐藏
home=主页
horizontal=水平对齐
horizontalFlow=水平对齐流
horizontalTree=向后水平对齐
image=图片
import=导入
invalidOrMissingFile=无效的或错误的文件
italic=斜体
landscape=方向
layout=对齐
left=居左
leftAlign=左对齐
line=线
lineend=线结束
linestart=线开始
linewidth=线的宽度
middle=居中
move=移动
navigation=导航
new=新建
noColor=没有颜色
noFiles=没有文件
none=无
north=北
opacity=透明度
open=打开...
openArrow=开放箭头
openFile=打开文件
openLink=打开链接
openSupported=支持.xml格式的文件保存
openInNewWindow=新建窗口
options=配置
organic=随机
orthogonal=正交
oval=椭圆
pages=页面
pageView=页面视图
pageScale=页面范围
pageSetup=页面设置
paperSize=纸张大小
paste=粘贴
perimeter=边界
plain=无格式
position=位置
posterPrint=海报印刷
preview=预览
print=打印
redo=重做
removeFromGroup=从组中移除
replace={1} 已经存在，是否替换?
replaceExistingDrawing=替换已存在的图形
right=居右
rightAlign=右对齐
rotate=旋转
rotation=旋转
rounded=圆形
save=保存
saveAs=另存为...
saved=已保存
scrollbars=滚动条
selectAll=全选
selectEdges=选择所有连接线
selectFont=选择字体
selectVertices=选择所有图元
setAsDefaultEdge=设置为默认连接线
shadow=阴影
shape=形状
size=大小
sourceSpacing=源间距
south=南
spacing=间距
straight=直线
strokeColor=线的颜色
style=样式
targetSpacing=目标间距
text=文本
textAlignment=文本对齐
textOpacity=文本透明
toBack=向前
toFront=向后
tooltips=提示
top=顶部
topAlign=顶部对齐
transparent=透明
underline=下划线
undo=撤消
ungroup=去消分组
url=URL
vertical=垂直
verticalFlow=垂直流
verticalTree=向下垂直对齐
view=视图
west=西
width=宽度
zoom=缩放
zoomIn=放大
zoomOut=缩小
coa=流程图元
other=辅助图元
coaLine=连接线